+-+-+-+-+-+
N |       |
+ + +-+-+ +
| | |   | |
+ + + + + +
| |P| |   |
+ + + +-+-+
| | | |P  |
+ + + +-+ +
|   |     F
+-+-+-+-+-+